C -2,0,1.5
S 1,1
mb
####....
#..#####
#......#
#..##G.#
#.####o#
#G#p14;#
########
........
........
........
........
........
........
........
B.......
........
########
#......#
#.G##..#
######.#
#..G...#
########
me
