C 0,0,.4
S 1,1
mb
#######.
#...G.#.
#..o..#.
#p4;..#.
#.....#.
#######.
........
........
........
........
........
........
........
........
........
........
........
B.......
.#######
.#G....#
.#######
me
