C 0,0,1
S 1,1
mb
..............
############..
#..........#..
#..........#..
#..........#..
#..p4;o....#..
#..........#..
#..G.......#..
############..
..............
..............
..............
..............
..............
..............
..............
B.............
..............
############..
#..........#..
#..........#..
#..........#..
#...G......#..
#..........#..
#..........#..
############..
me
