C 0,0,.3
S 1,1
mb
........
........
........
....###.
....#G#.
....#o#.
#####.#.
#p6;G.#.
#######.
........
........
........
........
........
........
........
........
........
........
........
........
B.......
....###.
....#.#.
....#.#.
....#.#.
....#.#.
....#G#.
..###.#.
..#...#.
..#####.
me
