C 0,0,1.5
S 1,1
mb
######..
#G...#..
###..###
###.o..#
#G..p6;#
########
........
........
........
........
........
........
........
B.......
########
#......#
#.#....#
#.#G...#
#......#
########
me
