C 0,0,1.5
S 1,1
mb
....###.
....#.#.
#####.##
#p7;o.G#
########
........
........
........
........
........
........
........
B.......
...####.
...#.G##
...#...#
...###.#
.....###
me
