C 0,0,1
S 1,1
mb
..............
############..
#..........#..
#..####.##.#..
#.#####....#..
#.....o.##.#..
#.##.##.##.#..
#p6;G......#..
############..
..............
..............
..............
..............
..............
..............
..............
B.............
..............
..............
..##########..
..#.......G#..
###.########..
#G...#.....#..
####.#.###.#..
...#.......#..
...#########..
me
