C -1,-1,1.5
S 1,1
mb
..#####.
..#.G.#.
..#...#.
..#...#.
#####.#.
#p6;Go#.
#######.
........
........
........
........
........
........
........
B.......
..####..
..#..#..
..#..##.
..#G..#.
#####.#.
#.....#.
#######.
me
